.................#..................#.................................
.................#..................#.................................
.................#....................................................
.................#..........................########################..
......................................................................
##################....................................................
.................#....................................................
.................#..................#.................................
.................#..................#.................................
.................#..................#.................................
.................#..................#########....#####................
......................................................................
################......................................................
...............#..........................#...........................
...............#.......###########........#...........................
...............#..........................#...........................
...............#..........................#...........................
...............#..........................#...........................
...............#..........................#.......##############......
...............#..........................#...........................